PatientID	INTEGER
room	INTEGER
Sta6a	INTEGER
PatientName	TEXT
Trial_ARM	INTEGER
prediction_datetime	REAL
respiratory_score	REAL
respiratory_class	INTEGER
respiratory_trend	INTEGER
septic_shock_score	REAL
septic_shock_class	INTEGER
septic_shock_trend	INTEGER
septic_shock_score_expl_pos_1	NUMERIC
septic_shock_score_expl_pos_2	NUMERIC
septic_shock_score_expl_pos_3	NUMERIC
septic_shock_score_expl_neg_1	NUMERIC
septic_shock_score_expl_neg_2	NUMERIC
septic_shock_score_expl_neg_3	NUMERIC
respitory_score_expl_pos_1	NUMERIC
respitory_score_expl_pos_2	NUMERIC
respitory_score_expl_pos_3	NUMERIC
respitory_score_expl_neg_1	NUMERIC
respitory_score_expl_neg_2	NUMERIC
respitory_score_expl_neg_3	NUMERIC
